32 32 -- Block size
0 0 -- Initial Tile position
images/frontTileSheet.png -- Tilesheet
8 8	-- Number of tiles in tilesheet
10,10,0,0,0,0,10,10,10,10,10,10,10,10,10,10,10,10,10,10,10,10,10,10,10,10,10,10,10,
10,10,0,0,0,0,10,10,10,10,10,10,10,10,10,10,10,10,10,10,10,10,10,10,10,10,10,10,10,
10,10,0,0,0,0,10,18,0,0,21,0,0,24,0,0,19,0,0,22,0,24,0,0,0,21,0,10,10,
10,10,0,0,0,0,10,0,18,0,0,21,22,23,0,22,0,0,18,0,0,21,0,23,0,0,0,10,10,
10,10,0,0,0,0,m,m,0,0,0,0,0,0,0,0,0,0,0,0,0,0,0,0,0,0,0,10,10,
10,10,0,0,0,0,0,0,0,0,0,0,0,0,0,0,0,0,0,0,0,0,0,0,0,0,0,10,10,
10,10,0,0,0,0,0,0,0,0,0,0,0,0,0,0,0,0,0,0,0,0,0,0,0,0,0,10,10,
10,10,17,0,0,0,0,0,0,0,0,0,0,0,0,0,0,0,0,0,0,0,0,0,0,0,0,10,10,
10,10,0,0,0,0,0,0,0,0,0,0,0,0,0,0,10,10,0,0,0,0,0,0,0,0,0,10,10,
10,10,0,0,0,0,0,0,0,0,0,0,0,0,0,0,10,10,0,0,0,10,10,10,10,10,10,10,10,
10,10,0,0,0,0,0,0,0,0,0,0,0,0,0,0,10,10,0,0,0,10,10,10,10,10,10,10,10,
10,10,0,0,0,0,0,0,0,0,0,0,0,0,0,0,10,10,0,0,0,0,0,0,0,0,0,10,10,
10,10,0,0,0,0,0,0,0,0,0,0,0,0,0,0,10,10,0,0,0,0,0,0,0,0,0,10,10,
10,10,0,0,0,0,0,0,0,0,0,0,0,0,0,0,10,10,0,0,0,0,0,0,0,0,0,10,10,
10,10,0,0,20,0,0,0,0,0,0,0,0,0,0,0,10,10,0,0,0,0,0,0,0,0,0,10,10,
10,10,0,0,0,0,0,0,0,0,0,0,0,0,0,0,10,10,m,m,0,0,0,0,0,0,0,10,10,
10,10,0,0,0,0,0,0,0,0,0,0,0,0,0,0,10,10,0,18,0,20,0,22,0,0,0,10,10,
10,10,0,0,0,0,0,0,0,0,0,0,0,0,0,0,10,10,0,0,21,0,23,0,0,0,0,10,10,
10,10,0,0,0,0,0,0,0,0,0,0,0,0,0,0,10,10,0,0,0,0,0,0,0,0,0,10,10,
10,10,0,0,0,0,0,0,0,0,0,0,0,0,0,0,10,10,0,0,0,0,0,0,0,0,0,10,10,
10,10,24,0,0,0,0,0,0,0,0,0,0,0,0,0,10,10,0,0,0,0,0,0,0,0,0,10,10,
10,10,0,0,0,0,0,0,0,0,0,0,0,0,0,0,10,10,0,0,0,0,0,0,m,m,m,10,10,
10,10,0,0,0,0,0,0,0,0,0,0,0,0,0,0,10,10,0,0,0,0,18,0,20,0,22,10,10,
10,10,10,10,10,10,10,10,10,10,10,10,0,0,0,0,10,10,0,0,0,0,0,21,0,24,0,10,10,
10,10,0,0,0,0,0,0,0,0,0,0,0,0,0,0,10,10,0,0,0,0,0,0,0,0,0,10,10,
10,10,0,0,0,0,0,0,0,0,0,0,0,0,0,0,10,10,0,0,0,0,0,0,0,0,0,0,0,
10,10,0,0,0,0,0,0,0,0,0,0,0,0,0,0,10,10,0,0,0,0,0,0,0,0,0,0,0,
10,10,0,41,0,0,0,0,0,0,0,0,0,0,0,0,10,10,0,0,0,0,0,0,0,0,0,0,0,
10,10,10,10,10,10,10,10,10,10,10,10,10,10,10,10,10,10,10,10,10,10,10,10,10,10,10,10,10,
10,10,10,10,10,10,10,10,10,10,10,10,10,10,10,10,10,10,10,10,10,10,10,10,10,10,10,10,10,

