64 64 -- Block size
0 32 -- Initial Tile position
images/tileSheet.png -- Tilesheet
8 8	-- Number of tiles in tilesheet
10,10,c16;4;27,c16;4;27,c16;4;27,c16;4;27,10,10,10,10,10,10,10,10,10,10,10,10,10,10,10,10,10,10,10,10,10,10,10,
10,10,0,0,0,0,10,10,10,10,10,10,10,10,10,10,10,10,10,10,10,10,10,10,10,10,10,10,10,
10,10,0,0,0,0,10,18,0,0,21,0,0,24,0,0,19,0,0,22,0,24,0,0,0,21,0,10,10,
10,10,0,0,0,0,10,0,18,0,0,21,22,23,0,22,0,0,18,0,0,21,0,23,0,0,0,10,10,
10,10,0,0,0,0,m10;0;6;25;5,m10;0;7;26;5,0,0,0,0,0,0,0,0,0,0,0,0,0,0,0,0,0,0,0,10,10,
10,10,0,0,0,0,0,0,0,0,0,0,0,0,0,0,0,0,0,0,0,0,0,0,0,0,0,10,10,
10,10,0,0,0,0,0,0,0,0,0,0,0,0,0,0,0,0,0,0,0,0,0,0,0,0,0,10,10,
10,10,17,0,0,0,0,0,0,0,0,0,0,0,0,0,0,0,0,0,0,0,0,0,0,0,0,10,10,
10,10,0,0,0,0,0,0,0,0,0,0,0,0,0,0,10,10,0,0,0,0,0,0,0,0,0,10,10,
10,10,0,0,0,0,0,0,0,0,0,0,0,0,0,0,10,10,0,0,0,10,10,10,10,10,10,10,10,
10,10,0,0,0,0,0,0,0,0,0,0,0,0,0,0,10,10,0,0,0,10,10,10,10,10,10,10,10,
10,10,0,0,0,0,0,0,0,0,0,0,0,0,0,0,10,10,0,0,0,0,0,0,0,0,0,10,10,
10,10,0,0,0,0,0,0,0,0,0,0,0,0,0,0,10,10,0,0,0,0,0,0,0,0,0,10,10,
10,10,0,0,0,0,0,0,0,0,0,0,0,0,0,0,10,10,0,0,0,0,0,0,0,0,0,10,10,
10,10,0,0,20,0,0,0,0,0,0,0,0,0,0,0,10,10,0,0,0,0,0,0,0,0,0,10,10,
10,10,0,0,0,0,0,0,0,0,0,0,0,0,0,0,10,10,m10;1;18;25;4,m10;1;19;26;4,0,0,0,0,0,0,0,10,10,
10,10,0,0,0,0,0,0,0,0,0,0,0,0,0,0,10,10,0,18,0,20,0,22,0,0,0,10,10,
10,10,0,0,0,0,0,0,0,0,0,0,0,0,0,0,10,10,0,0,21,0,23,0,0,0,0,10,10,
10,10,0,0,0,0,0,0,0,0,0,0,0,0,0,0,10,10,0,0,0,0,0,0,0,0,0,10,10,
10,10,0,0,0,0,0,0,0,0,0,0,0,0,0,0,10,10,0,0,0,0,0,0,0,0,0,10,10,
10,10,24,0,0,0,0,0,0,0,0,0,0,0,0,0,10,10,0,0,0,0,0,0,0,0,0,10,10,
10,10,0,0,0,0,0,0,0,0,0,0,0,0,0,0,10,10,0,0,0,0,0,0,m10;0;18;24;2,m10;0;19;25;2,m10;0;20;26;2,10,10,
10,10,0,0,0,0,0,0,0,0,0,0,0,0,0,0,10,10,0,0,0,0,18,0,20,0,22,10,10,
10,10,10,10,10,10,10,10,10,10,10,10,0,0,0,0,10,10,0,0,0,0,0,21,0,24,0,10,10,
10,10,0,0,0,0,0,0,0,0,0,0,0,0,0,0,10,10,0,0,0,0,0,0,0,0,0,10,10,
10,10,0,0,0,0,0,0,0,0,0,0,0,0,0,0,10,10,0,0,0,0,0,0,0,0,0,0,c19;3;27,
10,10,0,0,0,0,0,0,0,0,0,0,0,0,0,0,10,10,0,0,0,0,0,0,0,0,0,0,c19;3;27,
10,10,0,41,0,0,0,0,0,0,0,0,0,0,0,0,10,10,0,0,0,0,0,0,0,0,0,0,c19;3;27,
10,10,10,10,10,10,10,10,10,10,10,10,10,10,10,10,10,10,10,10,10,10,10,10,10,10,10,10,10,
10,10,10,10,10,10,10,10,10,10,10,10,10,10,10,10,10,10,10,10,10,10,10,10,10,10,10,10,10,

