64 64 -- Block size
0 32 -- Initial Tile position
images/tileSheet.png -- Tilesheet
8 8	-- Number of tiles in tilesheet
33,33,33,33,33,33,33,33,33,33,33,33,25,25,25,25,25,25,25,25,25,25,25,25,25,25,25,25,25,
33,33,33,33,33,33,33,33,33,33,33,33,25,25,25,25,25,25,25,25,25,25,25,25,25,25,25,25,25,
33,33,0,0,0,0,0,0,0,0,0,0,0,0,0,0,0,0,0,0,0,0,17,0,0,0,0,0,c8;3;3,
33,33,0,0,0,0,0,0,0,0,0,0,0,0,0,0,0,0,0,0,0,0,19,0,0,0,0,0,c8;3;3,
33,33,0,0,0,0,0,0,0,0,0,0,0,0,0,0,0,0,0,0,0,0,22,0,0,0,0,0,c8;3;3,
33,33,0,0,0,0,0,0,0,0,0,0,0,0,0,0,0,0,0,0,0,0,24,0,0,0,0,25,25,
33,33,0,0,0,0,33,33,33,33,33,33,25,25,25,25,25,25,0,0,0,0,17,0,0,0,0,25,25,
33,33,0,0,0,0,0,0,0,0,0,0,0,0,0,0,0,0,0,0,0,0,22,0,0,0,0,25,25,
33,33,0,0,0,21,0,0,0,0,0,0,0,0,0,0,0,0,0,0,0,0,19,0,0,0,0,25,25,
33,33,0,0,0,24,0,0,0,0,0,0,0,0,0,0,0,0,0,0,0,0,24,0,0,0,0,25,25,
33,33,0,0,0,19,0,0,0,25,25,25,25,25,25,25,25,25,25,25,25,25,17,0,0,0,0,25,25,
33,33,0,0,0,17,0,0,0,0,0,0,0,0,0,0,0,0,0,0,0,0,19,0,0,0,0,25,25,
33,33,0,0,0,20,0,0,0,17,0,0,0,0,0,0,0,0,0,0,0,0,24,0,0,0,0,25,25,
33,33,0,0,0,23,0,0,0,19,0,0,0,0,0,0,0,0,0,0,0,0,19,0,0,0,0,25,25,
33,33,0,0,0,24,0,0,0,23,0,0,0,0,0,0,0,0,0,0,0,0,0,0,0,0,0,25,25,
33,33,0,0,0,20,0,0,0,21,0,0,0,0,0,0,0,0,0,0,0,0,0,0,0,0,0,25,25,
33,33,0,0,0,23,0,0,0,19,0,0,0,0,0,0,0,0,0,0,0,0,0,0,0,0,0,25,25,
33,33,0,0,0,23,0,0,0,24,0,0,0,22,22,21,19,22,23,18,25,25,25,25,25,25,25,25,25,
33,33,0,0,0,20,0,0,0,23,0,0,0,0,0,0,0,0,0,0,0,0,0,0,0,0,0,25,25,
33,33,0,0,0,19,0,0,0,0,0,0,0,0,0,0,0,0,0,0,0,0,0,0,0,0,0,25,25,
33,33,0,0,0,21,0,0,0,0,0,0,0,0,0,0,0,0,0,0,0,0,0,0,0,0,0,25,25,
33,33,0,0,0,0,0,0,0,0,0,0,0,0,0,0,0,0,0,0,0,0,0,0,0,0,0,25,25,
33,33,0,0,0,0,33,33,33,33,33,33,33,33,33,33,17,19,22,24,21,22,33,33,33,33,33,25,25,
33,33,0,0,0,0,0,0,0,0,0,0,0,0,0,0,0,0,0,0,0,0,0,0,0,0,0,25,25,
33,33,0,0,0,0,0,0,0,0,0,0,0,0,0,0,0,0,0,0,0,0,0,0,0,0,0,25,25,
33,33,0,0,0,0,0,0,0,0,0,0,0,0,0,0,0,0,0,0,0,0,41,0,0,0,0,25,25,
33,33,0,0,0,0,0,0,0,0,0,0,0,0,0,0,33,33,33,33,33,33,33,33,0,0,0,25,25,
33,33,33,33,33,33,33,33,33,33,33,33,33,33,33,33,33,33,33,33,33,33,33,33,0,0,0,25,25,
33,33,33,33,33,33,33,33,33,33,33,33,33,33,33,33,33,33,33,33,33,33,33,33,0,0,0,25,25,
33,33,33,33,33,33,33,33,33,33,33,33,33,33,33,33,33,33,33,33,33,33,33,33,c11;26;3,c11;26;3,c11;26;3,25,25,
