64 64 -- Block size
0 32 -- Initial Tile position
images/tileSheet.png -- Tilesheet
8 8	-- Number of tiles in tilesheet
12,12,0,18,19,0,0,24,23,0,17,0,18,0,21,19,23,24,0,24,0,20,0,12,c11;26;27,c11;26;27,c11;26;27,12,12,
12,12,19,0,0,18,19,0,21,21,0,22,0,22,0,20,19,0,19,0,19,0,23,12,0,0,0,12,12,
12,12,0,0,0,0,0,0,0,0,0,0,0,0,0,0,0,0,0,0,0,0,m12;1;5;22;5,m12;1;6;23;5,0,0,0,12,12,
12,12,0,0,0,0,0,0,0,0,0,0,0,0,0,12,0,0,0,0,0,0,0,0,0,0,0,12,12,
12,12,0,0,0,0,0,0,0,0,0,0,0,0,0,19,0,0,0,0,0,0,0,0,0,0,0,12,12,
12,12,0,0,0,0,0,0,0,0,0,0,0,0,0,0,0,0,0,0,0,0,0,0,0,0,0,12,12,
12,12,0,0,0,0,0,0,0,0,0,0,0,0,0,0,0,0,0,19,0,0,0,0,0,0,0,12,12,
12,12,0,0,0,0,0,0,0,0,0,0,0,0,0,0,0,0,0,24,0,0,0,0,0,0,0,12,12,
12,12,0,0,0,0,0,0,0,0,0,0,0,0,0,0,0,0,0,18,0,0,41,0,0,0,0,12,12,
12,12,0,0,0,0,0,0,0,0,0,0,0,12,12,12,12,12,12,12,12,12,12,12,12,12,12,12,12,
12,12,0,0,12,12,0,0,0,0,0,0,0,12,12,12,12,12,0,0,0,0,12,12,12,12,12,12,12,
12,12,0,0,0,0,0,0,17,0,0,0,0,12,12,12,12,12,0,0,0,0,12,12,12,12,12,12,12,
12,12,0,0,0,0,0,0,0,0,19,20,21,0,0,0,0,0,0,0,0,0,0,0,0,0,0,12,12,
12,12,0,0,0,0,17,19,0,20,0,0,23,0,0,0,0,0,0,0,0,0,0,0,0,0,0,12,12,
12,12,0,0,0,0,0,0,0,0,0,0,0,0,0,0,0,0,0,0,0,0,0,0,0,0,0,12,12,
12,12,0,0,0,0,0,0,0,0,0,0,0,0,0,0,0,12,12,12,12,12,12,12,0,0,0,12,12,
12,12,0,0,0,0,0,0,0,0,0,0,0,0,0,0,0,12,0,0,0,0,0,0,0,0,0,12,12,
12,12,12,12,12,12,12,12,12,12,12,12,12,12,12,12,12,12,0,0,0,0,0,0,0,0,0,12,12,
12,12,0,0,0,0,0,12,12,12,12,12,0,0,0,0,0,12,0,0,0,0,0,0,0,0,0,12,12,
12,12,0,0,0,0,0,33,33,33,33,33,0,0,0,0,0,12,0,0,0,12,12,12,12,12,12,12,12,
12,12,0,0,0,0,0,0,0,0,0,0,0,0,0,0,0,0,0,0,0,12,12,12,12,12,12,12,12,
12,12,0,0,0,0,0,0,0,0,0,0,0,0,0,0,0,0,0,0,0,12,0,0,0,0,0,12,12,
12,12,0,0,0,0,0,0,0,0,0,0,0,0,0,0,0,0,0,0,0,12,0,0,0,0,0,12,12,
12,12,0,0,0,12,25,25,25,25,25,25,25,25,25,25,25,25,25,25,12,12,0,0,0,0,0,12,12,
12,12,0,0,0,0,0,0,0,0,0,0,0,0,0,0,0,0,0,0,0,0,0,0,0,0,0,12,12,
12,12,0,0,0,0,0,0,0,0,0,0,0,0,0,0,0,0,0,0,0,0,0,0,0,0,0,12,12,
12,12,0,0,0,0,0,0,0,0,0,0,0,0,0,0,0,0,0,0,0,0,0,0,0,0,0,12,12,
12,12,0,41,0,0,0,0,0,0,0,0,0,0,0,0,0,0,0,0,0,0,0,0,0,0,0,12,12,
12,12,12,12,12,12,12,12,12,12,12,12,12,12,12,12,12,12,12,12,12,12,12,12,0,0,0,12,12,
12,12,12,12,12,12,12,12,12,12,12,12,12,12,12,12,12,12,12,12,12,12,12,12,c14;26;3,c14;26;3,c14;26;3,12,12,
