TILEMAP
20 20 							-- Size of tile map in tiles
16 32 							-- Tile size & block size
images/blocks.png 	-- Tilesheet
2 2 								-- Number of tiles in tilesheet
11111111111111111111
1                  1
1                  1
1           11111111
1      11111       1
1                  1
1                  1
1  11111111111     1
1                  1
1                  1
1     22222222     1
1                  1
1  333333      444 1
1                  1
1  111111  111111  1
1                  1
1                  1
1                  1
1                  1
11111111111111111111

