TILEMAP
35 25 -- Size of tile map in tiles
32 64	-- Tile size & block size
images/tileSheet-prova.png -- Tilesheet
8 8	-- Number of tiles in tilesheet
11111111111111111111111111111111111
1                                 1
1                                 1
1                                 1
1                                 1
1                                 1
1                                 1
1                                 1
1                                 1
1                                 1
1                                 1
1          11111                  1
1              1                  1
1              11111              1
1                                 1
1                                 1
1    111111           1111111111  1
1                   111           1
1                                 1
1                                 1
1         11111                   1
1                 111             1
1                1111111          1
1            1111111111111        1
11111111111111111111111111111111111