32 32 -- Block size
0 0 -- Initial Tile position
images/frontTileSheet.png -- Tilesheet
8 8	-- Number of tiles in tilesheet
10,10,10,10,10,10,10,10,10,10,10,10,10,10,10,10,10,10,24,0,0,0,0,10,0,0,0,10,10,
10,10,10,10,10,10,10,10,10,10,10,10,10,10,10,19,19,22,18,0,0,0,0,10,0,0,0,10,10,
0,0,0,0,0,0,0,0,0,0,0,0,0,0,0,0,0,0,0,0,0,0,0,10,0,0,0,10,10,
0,0,0,0,0,0,0,0,0,0,0,0,0,0,0,0,0,0,0,0,0,0,0,10,0,0,0,10,10,
0,0,0,0,0,0,0,0,0,0,0,0,0,0,0,0,0,0,0,0,0,0,0,10,0,0,0,10,10,
0,0,0,0,0,0,0,0,0,0,0,0,0,0,0,0,0,0,0,0,0,0,0,10,0,0,0,10,10,
0,0,0,0,0,0,0,0,0,0,0,0,0,0,0,0,0,0,0,0,0,0,0,10,0,0,0,10,10,
19,20,18,17,10,10,10,10,10,10,10,10,10,10,10,10,10,10,10,10,10,0,0,0,0,0,0,10,10,
0,0,0,0,0,0,0,0,0,0,0,0,0,0,0,0,0,0,10,0,0,0,0,0,0,0,0,10,10,
0,0,0,0,0,0,0,0,0,0,0,0,0,0,0,0,0,0,10,0,0,0,0,0,0,41,0,10,10,
0,0,0,0,0,0,0,0,0,0,0,0,0,0,0,0,0,0,10,0,0,0,0,10,10,10,10,10,10,
10,10,10,10,10,10,10,10,10,10,10,10,10,10,10,0,0,0,10,0,0,0,0,0,10,0,0,0,0,
10,10,0,0,0,0,0,0,0,0,0,0,0,0,0,0,0,0,10,0,0,0,0,0,10,0,0,0,0,
10,10,0,0,0,0,0,0,0,0,0,0,0,0,0,0,0,0,10,0,0,0,0,0,10,0,0,0,0,
10,10,41,0,0,0,0,0,0,0,0,0,0,0,0,0,0,0,10,10,10,0,0,0,10,0,0,10,10,
10,10,10,10,10,10,10,0,0,0,0,0,0,0,0,0,0,0,10,10,10,0,0,0,10,0,0,10,10,
10,10,0,0,0,0,0,0,0,0,0,0,0,0,0,0,0,0,10,10,10,0,0,0,10,0,0,10,10,
10,10,0,0,0,0,0,0,0,0,0,0,0,0,0,0,0,0,10,10,10,0,0,0,10,0,0,10,10,
10,10,0,0,0,0,0,0,0,0,0,0,0,0,0,0,0,0,10,10,10,0,0,0,10,0,0,10,10,
10,10,0,0,10,10,10,10,10,10,10,10,10,10,10,10,10,10,10,10,10,0,0,0,10,0,0,10,10,
10,10,0,0,0,0,0,0,0,0,0,0,0,0,0,0,0,0,10,10,10,0,0,0,10,0,0,10,10,
10,10,0,0,0,0,0,0,0,0,0,0,0,0,0,0,0,0,10,10,10,0,0,0,10,0,0,10,10,
10,10,0,0,0,0,0,0,0,0,0,0,0,0,0,0,0,0,10,10,10,0,0,0,10,0,0,10,10,
10,10,10,10,10,10,10,10,10,10,10,10,10,10,10,0,0,0,10,10,10,0,0,0,10,0,0,10,10,
10,10,0,0,0,0,0,0,0,0,0,0,0,0,0,0,0,0,10,10,10,0,0,0,10,0,0,10,10,
10,10,0,0,0,0,0,0,0,0,0,0,0,0,0,0,0,0,10,10,10,0,0,0,10,0,0,0,0,
10,10,0,0,0,0,0,0,0,0,0,0,0,0,0,0,0,0,10,10,10,0,0,0,10,0,0,0,0,
10,10,0,0,0,0,0,0,0,0,0,0,0,0,0,0,41,0,10,10,10,0,0,0,10,0,0,0,0,
10,10,0,0,0,0,10,10,10,10,10,10,10,10,10,10,10,10,10,10,10,0,0,0,10,10,10,10,10,
10,10,0,0,0,0,10,10,10,10,10,10,10,10,10,10,10,10,10,10,10,0,0,0,10,10,10,10,10,
